########################################
#                                                                                                                 #
#                                                                                                                 #
# ERROR: KOD BLEDU 1296257802-49: STACJA NIE ODPOWIADA #
#                                                                                                                 #
0101011101101001011000010110010001101111011011010110111
1011100110110001100100000011011110110010000100000011101
0001110111011011110111001001100011011110010011101000100
0000111011101101001011001000110111101100011011110100110
1110011010010110010100100000011011000111010101100010011
0100101110011011110100010000001100100011100100110111101
1000100110111001100101001000000110010101100001011100110
1110100011001010111001000101101011001010110011101101001
0010111000100000010101000110111100100000011010100110010
1011100110111101001100011011110100110010100100000011011
1001101001011001010010000001101011011011110110111001101
0010110010101100011001011100010000001001110011010010110
0101001000000111101001100001011100110111010001100001011
0111001100001011101110110100101100001001000000110001101
1010010110010100100000011100110110101101100001011001000
0100000011100110110100101100101001000000111011101111010
0110100101100001011011000010000001110100011001010110111
0001000000110101101101111011001000010000001100010011011
0001100101011001000111010100111111001000000100110101101
1110111101001100101001000000111010001101111001000000111
0000011100100111101001111001011100000110000101100100011
0101101101111011101110110010100100000011000110111100101
1001100111001001111001001011000010000001100001001000000
1101101011011110111101001100101001000000110111001101001 
01100101001011100010111000101110
#                                                                                                                 #
#    odpowiedz: 6 2 26 50 8 16 25 37 28 105 38 44 1 60
     12 14 34 17 6 50 51 71 72 39 52                            #
#                                                                                                                 #
#                                                                                                                 #
#                                                                                                                 #
#                                                                                                                 #
#                                                                                                                 #
#                                                                                                                 #
########################################


